30>
15>
TTTTTTTTTTTTTTTTTTTTTTTTTTTTTT
T............................T
T............................T
T~~~~~.......................T
~~~~~~~......................T
~~..~~~~............~~~~~....T
T....~~~~.........~~~~~~~~~..T
T....~~~~........~~~~...~~~~.T
T.....~~~~......~~~~....~~~~~~
T.....~~~~~.....~~~~......~~~~
T......~~~~~...~~~~..........T
T........~~~~~~~~~...........T
T..........~~~~~.............T
T............................T
TTTTTTTTTTTTTTTTTTTTTTTTTTTTTT
